WWWWWWWWWW
WEEEEEEEEW
WEEEEEEEEW
WEWWWWWEEW
WEEEEEWEEW
WEEMMMWEEW
WEEPEEEEEW
WEEEEEEEEW
WEEEEEEEEW
WWWWWWWWWW
-
WWWWWWWWWW
WEEEEEEEEW
WEEEEEEEEW
WEWWWWWEEW
WEEMEEWEEW
WEEEMMWEEW
WEEPEEEEEW
WEEEEEEEEW
WEEEEEEEEW
WWWWWWWWWW